01 01 01 01 01 01 01 01 01 01 01 01 01 01 01 01 01 01 01 01 01 01 01 01 01 01 01 01 01 01 01 01 01 01 01 01 01 01 01 01 01 01 01 01 01 01 01 01 01 01 01 01 01 01 01 01 01 01 01 01 01 01 01 01 01 01 01 01 01 01 01 01 01 01 01
01 02 02 02 02 02 02 02 02 02 02 02 02 02 05 05 05 00 00 00 00 00 00 00 00 00 00 00 00 00 00 00 00 00 00 00 00 00 00 00 00 00 00 00 00 00 00 00 00 00 00 00 02 02 02 02 02 02 02 02 02 02 02 02 02 02 02 02 02 02 02 02 02 02 01
01 02 02 02 02 02 02 02 02 02 02 02 02 05 05 05 05 00 00 00 00 00 00 00 00 00 00 00 00 00 00 00 00 00 00 00 00 00 00 00 00 00 00 00 00 00 00 00 00 00 00 00 00 00 02 02 02 02 02 02 02 02 02 02 02 02 02 02 02 02 02 02 02 02 01
01 02 02 02 02 02 02 02 02 02 02 02 02 05 05 05 05 00 00 00 00 00 00 00 00 00 00 00 00 00 00 00 00 00 00 00 00 00 00 00 00 00 00 00 00 00 00 00 00 00 00 00 00 00 00 02 02 02 02 02 02 02 02 02 02 02 02 02 02 02 02 02 02 02 01
01 02 02 02 02 02 02 02 02 02 02 02 02 02 05 05 05 00 00 00 00 00 00 00 00 00 00 00 00 00 00 00 00 00 00 00 00 00 00 00 00 00 00 00 00 00 00 00 00 00 00 00 00 00 00 02 02 02 02 02 02 02 02 02 02 02 02 02 02 02 02 02 02 02 01
01 02 02 02 02 02 02 02 02 02 02 02 02 02 05 05 05 00 00 00 00 00 00 00 00 00 00 00 00 00 00 00 00 00 00 00 00 00 00 00 00 00 00 00 00 00 00 00 00 00 00 00 00 00 00 00 00 02 02 02 02 02 02 02 02 02 02 02 02 02 02 02 02 02 01
01 02 02 02 02 02 02 02 02 02 02 02 02 04 04 04 04 04 04 04 04 04 04 04 04 04 04 04 04 04 04 04 04 04 04 04 04 04 04 04 04 04 04 04 04 04 04 04 04 04 04 04 04 04 04 04 04 02 02 02 02 02 02 02 02 02 02 02 02 02 02 02 02 02 01
01 02 02 02 02 02 02 02 02 02 02 02 05 05 05 00 00 00 00 00 00 00 00 06 00 00 00 00 00 00 01 01 01 01 01 01 01 01 01 01 00 00 00 00 06 00 00 00 00 00 00 00 00 00 00 00 00 02 02 02 02 02 02 02 02 02 02 02 02 02 02 02 02 02 01
01 02 02 02 02 02 02 02 02 02 02 02 05 05 05 00 00 06 00 00 00 00 00 00 00 00 00 00 00 01 07 07 07 07 07 07 07 07 07 07 01 00 00 00 00 00 00 18 00 00 00 00 00 00 00 00 00 02 02 02 02 02 02 02 02 02 02 02 02 02 02 02 02 02 01
01 02 02 02 02 02 02 02 02 02 02 02 05 05 05 00 00 18 00 00 00 00 00 00 00 00 00 00 01 07 07 07 07 07 07 07 07 07 07 07 07 01 00 00 00 00 00 00 00 00 00 00 00 00 00 00 00 02 02 02 02 02 02 02 02 02 02 02 02 02 02 02 02 02 01
01 02 02 02 02 02 02 02 02 02 02 02 02 05 05 05 00 00 00 00 00 00 00 00 17 00 00 00 01 07 07 07 07 07 07 07 07 07 07 21 07 01 00 06 00 00 00 00 06 00 17 00 00 00 00 00 00 00 02 02 02 02 02 02 02 02 02 02 02 02 02 02 02 02 01
01 02 02 02 02 02 02 02 02 02 02 02 02 02 05 05 00 00 00 06 00 00 00 00 00 00 00 00 01 07 07 07 07 07 07 07 07 07 07 20 07 01 00 00 00 00 00 00 00 00 00 00 00 18 00 00 00 00 00 00 02 02 02 02 02 02 02 02 02 02 02 02 02 02 01
01 02 02 02 02 02 02 02 02 02 02 02 02 02 05 05 00 00 00 00 00 00 00 00 00 06 00 00 01 07 07 07 07 07 07 07 07 07 07 07 07 01 00 00 00 00 00 00 00 00 00 00 00 00 00 00 00 00 17 00 00 00 00 02 02 02 02 02 02 02 02 02 02 02 01
01 02 02 02 02 02 02 02 02 02 02 02 02 05 05 05 00 00 00 00 00 00 00 00 00 00 00 00 00 01 07 07 07 07 07 07 07 07 07 07 01 00 00 00 00 00 06 00 00 18 00 00 00 06 00 00 00 00 00 00 00 00 00 00 02 02 02 02 02 02 02 02 02 02 01
01 02 02 02 02 02 02 02 02 02 02 02 05 05 05 05 00 00 00 00 00 18 06 00 00 00 00 00 00 00 01 01 01 01 07 07 01 01 01 01 00 00 00 00 00 00 00 00 00 00 00 00 00 00 00 00 00 00 00 00 00 00 00 00 02 02 02 02 02 02 02 02 02 02 01
01 02 02 02 02 02 02 02 02 02 02 02 05 05 05 05 00 17 06 00 00 00 00 00 00 00 00 17 00 00 00 00 00 03 05 05 03 00 00 00 00 06 00 00 00 00 00 00 00 00 00 00 00 00 00 00 00 00 06 00 00 00 00 00 00 00 00 04 00 00 02 02 02 02 01
01 02 02 02 02 02 02 02 02 02 02 02 05 05 05 05 05 00 00 00 00 00 00 00 00 00 00 00 00 00 00 00 00 15 05 05 15 00 00 00 00 00 00 00 00 18 00 00 06 00 00 00 00 17 00 00 00 00 00 00 00 00 00 00 00 00 00 04 00 00 00 00 00 00 01
01 02 02 02 02 02 02 02 02 02 02 02 02 05 05 05 05 00 00 00 00 00 00 06 00 00 00 00 00 00 00 00 00 17 05 05 16 00 18 00 00 00 00 00 00 00 00 00 00 00 00 00 00 00 00 00 00 00 00 00 00 00 00 00 00 00 00 04 00 00 00 00 00 00 01
01 02 02 02 02 02 02 02 02 02 02 02 02 02 05 05 05 05 05 00 00 00 00 00 00 00 00 00 06 00 00 00 00 18 05 05 18 00 00 00 00 00 00 06 00 00 00 00 00 00 00 00 00 00 06 00 18 00 00 00 00 17 06 00 00 00 00 04 00 00 00 00 00 00 01
01 02 02 02 02 02 02 02 02 02 02 02 02 02 05 05 05 05 05 00 00 00 00 00 00 00 00 00 00 00 00 00 00 16 05 05 17 00 00 00 06 00 00 00 00 00 00 00 00 06 00 18 00 00 00 00 00 00 06 00 00 00 00 00 00 00 00 04 00 00 00 00 00 00 01
01 02 02 02 02 02 02 02 02 02 02 02 02 02 02 05 05 05 05 00 18 00 00 17 00 00 00 00 00 00 00 00 00 15 05 05 16 00 00 00 00 00 00 00 00 00 00 00 00 00 00 00 00 00 00 00 00 00 00 00 00 00 00 00 00 00 00 04 00 00 00 00 00 00 01
01 02 02 02 02 02 02 02 02 02 02 02 02 02 02 05 05 05 05 05 00 00 00 00 00 00 00 00 18 00 00 00 00 03 05 05 03 00 00 00 00 18 00 00 00 00 00 00 00 00 04 04 04 04 04 04 04 04 04 00 00 00 00 06 00 00 00 04 00 00 00 00 00 00 01
01 02 02 02 02 02 02 02 02 02 02 02 02 02 02 05 05 05 05 05 00 00 00 00 00 00 00 00 00 00 00 06 06 06 05 05 06 06 06 00 00 00 00 00 06 00 00 00 00 04 00 00 00 00 00 00 00 00 00 04 00 00 00 00 00 00 00 04 00 00 00 00 00 00 01
01 02 02 02 02 02 02 02 02 02 02 02 02 02 02 05 05 05 05 05 00 00 00 00 00 00 00 00 00 00 00 06 05 05 05 05 05 05 06 00 00 00 00 00 00 00 00 00 00 04 00 00 15 00 00 00 00 04 16 00 04 00 00 00 00 00 00 04 00 00 00 00 00 00 01
01 07 07 07 07 07 07 07 07 07 07 07 07 07 07 07 05 05 05 05 03 16 17 16 18 15 16 18 15 17 03 06 05 05 05 05 05 05 06 03 16 17 16 18 15 16 18 15 03 04 00 00 00 00 04 00 00 00 00 00 04 00 00 18 00 00 00 04 00 00 00 00 00 00 01
01 07 07 07 07 07 07 07 07 07 07 07 07 07 07 07 05 05 05 05 05 05 05 05 05 05 05 05 05 05 05 05 05 05 05 05 05 05 05 05 05 05 05 05 05 05 05 05 05 00 00 00 00 00 00 00 00 00 00 00 04 00 00 00 00 00 00 04 00 00 00 00 00 00 01
01 02 02 02 02 02 02 02 02 02 02 02 02 02 02 02 05 05 05 05 05 05 05 05 05 05 05 05 05 05 05 05 05 05 05 05 05 05 05 05 05 05 05 05 05 05 05 05 05 00 00 00 00 00 00 00 00 16 00 00 04 00 00 00 00 00 06 04 00 00 00 00 00 00 01
01 02 02 02 02 02 02 02 02 02 02 02 02 02 02 05 05 05 05 05 03 16 17 16 18 15 16 18 15 17 03 06 05 05 05 05 05 05 06 03 16 17 16 18 15 16 18 15 03 04 00 18 00 00 00 00 00 00 04 00 04 00 00 00 00 00 00 04 00 00 00 00 00 00 01
01 02 02 02 02 02 02 02 02 02 02 02 02 02 05 05 05 05 05 05 00 00 00 00 00 00 00 00 00 00 00 06 05 05 05 05 05 05 06 00 00 00 00 00 00 00 00 00 00 04 00 00 00 00 04 00 00 00 00 17 04 00 00 00 00 00 00 04 00 00 00 00 00 00 01
01 02 02 02 02 02 02 02 02 02 02 02 02 05 05 05 05 05 05 00 00 00 00 00 00 00 00 00 00 00 00 06 06 06 05 05 06 06 06 00 00 00 00 00 00 00 00 00 00 04 00 00 00 00 00 00 17 00 00 04 00 00 00 00 00 00 00 04 00 00 00 00 00 00 01
01 02 02 02 02 02 02 02 02 02 02 02 05 05 05 05 05 00 00 00 00 00 00 00 00 00 00 00 00 00 00 00 00 03 05 05 03 00 00 00 00 00 00 00 06 00 00 00 00 00 04 04 04 04 04 04 04 04 04 00 00 00 06 00 00 18 00 04 00 00 00 00 00 00 01
01 02 02 02 02 02 02 02 02 05 05 05 05 05 05 00 00 00 17 00 00 00 06 00 00 00 00 00 00 06 00 00 00 17 05 05 15 00 00 06 00 18 00 00 00 00 00 00 00 00 00 00 18 00 00 00 00 00 00 00 00 00 00 00 00 00 00 04 00 00 00 00 00 00 01
01 02 02 02 02 02 02 02 05 05 05 05 00 00 00 00 00 00 00 00 00 00 00 00 00 00 00 00 00 00 00 00 00 16 05 05 16 00 18 00 00 00 00 00 00 00 00 06 00 00 00 00 00 00 00 00 00 00 00 00 00 00 00 00 00 00 00 04 00 00 00 00 00 00 01
01 02 02 02 02 02 05 04 05 05 05 00 00 00 00 18 00 06 00 00 00 00 00 00 00 00 17 00 00 00 00 00 00 15 05 05 18 00 00 00 00 00 00 00 00 00 00 00 00 00 00 00 00 00 06 00 00 00 18 00 00 00 00 00 00 00 00 04 00 00 00 00 00 00 01
01 02 02 02 02 02 05 04 05 00 00 00 06 00 00 00 00 00 00 00 00 00 00 00 06 00 00 00 00 00 00 00 00 17 05 05 17 00 00 00 00 00 00 00 00 00 00 18 00 00 06 00 00 00 00 00 00 00 00 00 00 00 00 00 00 00 00 04 00 00 00 00 00 00 01
01 02 02 02 02 05 05 04 00 00 00 00 00 00 00 00 00 00 06 00 00 00 00 00 00 00 00 00 00 00 00 00 00 16 05 05 15 00 00 06 00 00 00 00 00 00 00 00 00 00 00 00 18 00 00 00 00 00 00 00 00 00 00 06 00 00 00 04 00 00 00 00 00 00 01
01 05 05 05 05 05 00 04 00 00 00 00 00 00 00 00 00 00 00 00 00 00 00 00 00 00 00 00 18 00 06 00 00 18 05 05 18 00 00 00 18 00 00 00 06 00 00 00 00 00 00 00 00 00 00 00 00 00 00 00 00 00 00 18 00 00 00 04 00 00 00 00 00 00 01
01 00 00 00 00 00 00 04 00 06 00 00 00 00 06 00 18 00 00 00 00 00 00 00 00 06 00 00 00 00 00 00 00 15 05 05 17 00 00 00 00 00 00 00 00 00 00 00 00 00 00 00 00 00 00 06 00 00 00 00 00 00 00 00 00 00 00 04 00 00 00 00 00 00 01
01 00 00 00 00 00 00 04 00 00 00 00 17 00 00 00 00 00 00 00 10 10 10 10 00 00 00 00 00 00 00 00 00 16 05 05 16 00 00 00 00 00 00 00 18 00 10 10 10 10 00 00 18 00 00 00 00 00 00 00 00 00 00 00 00 00 00 04 00 00 00 00 00 00 01
01 00 00 00 00 00 00 04 00 00 00 00 00 00 00 00 00 00 06 10 07 07 07 07 10 03 17 16 18 15 16 18 17 03 05 05 03 17 16 15 17 16 15 17 03 10 07 07 07 07 10 00 00 00 00 00 00 00 00 18 00 00 00 00 00 00 00 04 00 00 00 00 00 00 01
01 00 00 00 00 00 00 04 00 00 00 00 00 00 00 00 00 00 00 10 07 07 07 07 07 05 05 05 05 05 05 05 05 05 05 05 05 05 05 05 05 05 05 05 05 07 07 07 07 07 10 00 00 00 00 00 00 00 00 00 00 00 06 00 00 00 00 04 00 00 00 00 00 00 01
01 00 00 00 00 00 00 04 00 00 00 00 00 06 00 00 00 00 00 10 07 07 07 07 07 05 05 05 05 05 05 05 05 05 05 05 05 05 05 05 05 05 05 05 05 07 07 07 07 07 10 00 00 00 06 00 00 00 00 00 00 00 00 00 00 00 00 04 00 00 00 00 00 00 01
01 00 00 00 00 00 00 04 00 00 00 00 00 00 00 00 17 00 00 10 07 07 07 07 10 03 17 15 18 17 16 15 17 03 05 05 03 17 16 18 15 16 18 15 03 10 07 07 07 07 10 00 00 00 00 18 00 00 00 00 00 00 00 00 00 18 00 04 00 00 00 00 00 00 01
01 00 00 00 00 00 00 04 00 00 06 00 00 00 00 00 00 00 00 00 10 10 10 10 00 00 00 00 00 00 00 00 00 10 07 07 10 00 00 00 00 00 00 00 00 00 10 10 10 10 00 00 00 00 00 00 00 00 00 00 00 00 00 00 00 00 00 04 00 00 00 00 00 00 01
01 00 00 00 00 00 00 04 00 00 00 18 00 00 00 00 00 06 00 00 00 00 00 00 00 00 00 00 00 00 00 00 10 07 07 07 07 10 00 18 00 00 06 00 00 00 00 00 00 00 00 00 00 17 00 00 00 06 00 00 00 00 00 00 00 00 00 04 00 00 00 00 00 00 01
01 00 00 00 00 00 00 04 00 00 00 00 00 00 00 00 00 00 00 00 06 00 00 00 00 00 00 00 00 00 17 00 10 07 07 07 07 10 00 00 00 00 00 00 18 00 00 00 00 00 06 00 00 00 00 00 00 00 00 00 00 00 17 00 00 00 00 04 00 00 00 00 00 00 01
01 00 00 00 00 00 00 04 00 17 00 00 00 00 00 00 00 00 00 00 00 00 00 00 00 00 06 00 00 00 00 00 10 07 07 07 07 10 06 00 00 00 00 00 00 00 00 00 00 00 00 00 00 00 00 00 00 00 18 00 00 00 00 00 00 00 00 04 00 00 00 00 00 00 01
01 00 00 00 00 00 00 04 00 00 00 06 00 00 00 00 00 00 00 04 00 00 00 17 00 00 00 00 00 00 00 04 10 07 07 07 07 10 00 00 00 00 00 04 00 00 00 00 00 18 00 00 00 00 00 00 06 00 00 00 00 06 00 00 00 00 00 04 00 00 00 00 00 00 01
01 00 00 00 00 00 00 04 00 00 00 00 00 00 04 00 00 00 00 00 00 00 00 00 00 00 00 00 00 00 00 00 00 10 10 10 10 00 00 18 00 00 00 00 06 00 00 00 00 00 00 06 00 00 17 00 00 00 00 00 00 00 00 00 18 00 00 04 00 00 00 00 00 00 01
01 00 00 00 00 00 00 04 00 00 00 00 00 00 00 00 00 00 00 06 00 00 00 00 04 00 00 00 04 00 00 00 00 00 00 00 00 00 00 00 00 00 00 00 00 00 04 00 00 00 00 00 00 00 00 00 00 00 00 00 00 06 00 00 00 00 00 04 00 00 00 00 00 00 01
01 00 00 00 00 00 00 04 00 00 00 00 06 00 00 00 04 00 00 00 00 00 00 00 06 00 00 18 00 00 00 00 00 00 00 00 00 00 06 00 00 00 00 00 00 00 00 00 00 00 00 00 00 00 00 00 00 00 00 00 00 00 00 00 00 00 00 04 00 00 00 00 00 00 01
01 00 00 00 00 00 00 04 00 00 00 00 00 18 00 00 00 00 00 00 00 00 04 00 00 00 00 00 00 04 00 00 00 00 00 00 00 00 00 00 00 00 00 00 00 00 00 17 00 00 00 04 00 00 00 00 06 00 00 00 00 18 00 00 00 00 06 04 00 00 00 00 00 00 01
01 00 00 00 00 00 00 04 00 00 00 00 00 00 00 00 00 00 00 00 00 00 00 00 17 00 00 00 00 00 00 00 00 00 00 00 00 00 00 00 17 06 00 00 00 00 00 00 00 00 00 00 00 00 17 00 00 00 00 00 00 00 00 00 00 00 00 04 00 00 00 00 00 00 01
01 00 00 00 00 00 00 04 00 00 17 00 00 00 00 00 00 06 00 00 00 00 00 00 00 00 00 00 00 00 00 00 00 06 00 00 00 00 00 00 00 00 00 00 00 00 00 06 00 00 00 00 00 00 00 00 00 00 00 00 06 00 00 00 00 00 00 04 00 00 00 00 00 00 01
01 00 00 00 00 00 00 04 00 00 00 00 00 00 00 00 00 00 00 00 00 00 04 00 00 00 00 18 04 00 00 00 00 00 00 00 00 00 00 00 00 00 00 00 00 00 00 00 00 00 00 00 04 00 00 00 00 00 00 00 00 00 00 00 06 00 00 04 00 00 00 00 00 00 01
01 00 00 00 00 00 00 04 00 00 00 00 06 00 00 00 00 00 00 00 00 00 00 00 00 00 00 00 00 00 00 00 00 00 00 00 00 00 00 00 00 00 00 00 00 00 00 00 00 00 00 00 00 00 00 17 00 00 00 00 00 00 00 00 00 00 00 04 00 00 00 00 00 00 01
01 00 00 00 00 00 00 04 00 00 00 00 00 00 00 00 17 00 00 00 00 00 00 00 00 00 06 00 00 04 00 00 00 17 00 00 00 00 00 00 06 00 00 00 06 00 00 00 00 04 00 00 00 00 00 00 00 00 00 00 00 00 00 00 17 00 00 04 00 00 00 00 00 00 01
01 00 00 00 00 00 00 04 00 00 00 00 00 00 00 00 06 00 00 00 00 00 17 00 00 00 00 00 17 00 00 00 00 00 00 04 00 00 00 00 00 00 00 00 00 00 00 00 17 00 00 00 00 00 00 00 00 00 00 00 00 00 00 00 00 00 00 04 00 00 00 00 00 00 01
01 00 00 00 00 00 00 04 00 06 00 00 00 00 00 00 00 00 00 00 00 00 00 00 00 18 00 00 00 06 00 00 00 00 18 00 00 00 00 00 00 00 00 00 00 00 00 00 05 05 05 05 05 00 00 00 00 00 00 00 00 00 00 00 00 00 00 04 00 00 00 00 00 00 01
01 00 00 00 00 00 00 04 00 00 00 18 00 00 00 00 00 00 00 00 00 00 00 06 00 00 00 00 00 00 00 00 00 00 00 00 00 00 00 00 17 00 00 04 00 00 00 05 05 02 02 02 05 05 05 05 00 00 00 00 00 00 00 00 00 06 00 04 00 00 00 00 00 00 01
01 00 00 00 00 00 00 04 00 00 17 00 00 00 06 00 00 00 00 06 00 00 00 00 00 00 00 00 00 00 00 00 00 00 00 00 00 00 00 00 00 00 00 00 00 00 05 05 02 02 02 02 02 02 02 05 00 00 00 00 00 00 00 00 00 00 00 04 00 00 00 00 00 00 01
01 00 00 00 00 00 00 04 00 00 00 00 00 00 00 00 00 00 00 00 00 00 00 00 17 00 00 00 00 00 00 00 06 00 00 00 00 00 00 06 00 00 00 00 00 05 05 02 02 02 02 02 02 02 02 05 05 00 06 17 00 00 00 00 00 00 00 04 00 00 00 00 00 00 01
01 00 00 00 00 00 00 04 00 00 00 00 00 00 00 00 00 00 00 00 00 00 00 00 00 00 06 00 00 00 00 00 00 00 00 17 00 00 00 00 00 00 00 00 00 05 02 02 02 02 02 02 02 02 02 02 05 00 00 00 00 00 00 00 00 00 00 04 00 00 00 00 00 00 01
01 00 00 00 00 00 00 04 00 00 00 00 00 00 00 00 17 00 00 00 06 00 00 00 00 00 00 00 00 00 00 00 00 00 00 06 00 00 00 00 00 00 00 18 00 05 02 02 02 02 02 02 02 02 02 02 05 00 00 00 00 00 00 00 00 00 00 04 00 00 00 00 00 00 01
01 00 00 00 00 00 00 04 00 00 06 00 00 00 00 00 00 00 00 00 00 00 00 00 00 00 00 00 00 00 06 00 00 00 00 00 00 00 00 00 00 00 00 00 00 05 05 02 02 02 02 02 02 02 02 05 05 00 00 00 00 00 00 06 17 00 00 04 00 00 00 00 00 00 01
01 00 00 00 00 00 00 04 00 00 00 00 00 00 00 00 06 00 00 00 00 00 00 00 00 00 00 00 00 00 17 00 00 00 00 18 00 00 00 00 00 00 00 00 00 00 05 05 02 02 02 02 02 02 05 05 00 00 00 00 00 00 00 00 00 00 00 04 00 00 00 00 00 00 01
01 00 00 00 00 00 00 04 00 00 00 00 00 00 00 00 00 00 00 00 17 00 00 00 00 00 00 00 00 00 00 00 00 00 00 00 00 00 00 00 00 17 00 00 00 00 00 05 05 05 05 05 05 05 00 00 00 17 00 00 00 00 00 00 00 00 00 04 00 00 00 00 00 00 01
01 00 00 00 00 00 00 04 04 04 04 04 04 04 04 04 04 04 04 04 04 04 04 04 04 04 04 04 04 04 04 04 04 04 04 04 04 04 04 04 04 04 04 04 04 04 04 04 04 04 04 04 04 04 04 04 04 04 04 04 04 04 04 04 04 04 04 04 00 00 00 00 00 00 01
01 00 00 00 00 00 00 00 00 00 00 00 00 00 00 00 00 00 00 00 00 00 00 00 00 00 00 00 00 00 00 00 00 00 00 00 00 00 00 00 00 00 00 00 00 00 00 00 00 00 00 00 00 00 00 00 00 00 00 00 00 00 00 00 00 00 00 00 00 00 00 00 00 00 01
01 00 00 00 00 00 00 00 00 00 00 00 00 00 00 00 00 00 00 00 00 00 00 00 00 00 00 00 00 00 00 00 00 00 00 00 00 00 00 00 00 00 00 00 00 00 00 00 00 00 00 00 00 00 00 00 00 00 00 00 00 00 00 00 00 00 00 00 00 00 00 00 00 00 01
01 00 00 00 00 00 00 00 00 00 00 00 00 00 00 00 00 00 00 00 00 00 00 00 00 00 00 00 00 00 00 00 00 00 00 00 00 00 00 00 00 00 00 00 00 00 00 00 00 00 00 00 00 00 00 00 00 00 00 00 00 00 00 00 00 00 00 00 00 00 00 00 00 00 01
01 00 00 00 00 00 00 00 00 00 00 00 00 00 00 00 00 00 00 00 00 00 00 00 00 00 00 00 00 00 00 00 00 00 00 00 00 00 00 00 00 00 00 00 00 00 00 00 00 00 00 00 00 00 00 00 00 00 00 00 00 00 00 00 00 00 00 00 00 00 00 00 00 00 01
01 00 00 00 00 00 00 00 00 00 00 00 00 00 00 00 00 00 00 00 00 00 00 00 00 00 00 00 00 00 00 00 00 00 00 00 00 00 00 00 00 00 00 00 00 00 00 00 00 00 00 00 00 00 00 00 00 00 00 00 00 00 00 00 00 00 00 00 00 00 00 00 00 00 01
01 00 00 00 00 00 00 00 00 00 00 00 00 00 00 00 00 00 00 00 00 00 00 00 00 00 00 00 00 00 00 00 00 00 00 00 00 00 00 00 00 00 00 00 00 00 00 00 00 00 00 00 00 00 00 00 00 00 00 00 00 00 00 00 00 00 00 00 00 00 00 00 00 00 01
01 01 01 01 01 01 01 01 01 01 01 01 01 01 01 01 01 01 01 01 01 01 01 01 01 01 01 01 01 01 01 01 01 01 01 01 01 01 01 01 01 01 01 01 01 01 01 01 01 01 01 01 01 01 01 01 01 01 01 01 01 01 01 01 01 01 01 01 01 01 01 01 01 01 01